 
 
 166 in person  : Ƹୟଂ, ନିେଜ 
in place  of : ବଦଳେର , ପରିବେŧƽ  
in point  of law : ବିǇଦୃƨିର ୁ , ଆଇନ  ଦୃƨିର ୁ 
in preference  to : ଅǇକ  ପସƃପୂବƽକ , ଏକାǇକ  
ଜିନିଷ /ତ ୁ ଳନାŮକ  ଭାେବ  
in proportion  to : ଅନୁପାତେର  
in pursuance  of : ଅନୁସରଣେର  
in regard  to : ବିଷୟେର  
in relation  to : ସƓକƽେର /Ȅସŏେର  
in respect  of : ବାବଦେର , ସଂǰାŽେର  
in restraint  of : ଅବେରାଧ  ǰେମ 
in road  : ହଠାǘ  ଆǰମଣ  
in satisfaction of  : 1. ପରିେଶାଧ  ନିମେŽ , 2. ସେŽାଷ  
ନିମେŽ  
in so much  : େଯେତ  ପରିମାଣ , ଏ ପଯƽȻŽ  
in spite  of : ସେŨ 
in status  quo : ପୂବƽାବƳାେର , ƳିତାବƳାେର  
in stead  / instead of  : ପରିବେŧƽ  
in substitution  of : 1.ȄତିƳାପନ  କରି, 2.ପରିବେŧƽ  
in that : େସଇ କାରଣର ୁ , େସǆେର , ତହǂେର  
in the absence -of : ଅନୁପƳିତିେର , ଅଭାବେର  
in the air : ଉଡ଼ାଖବର , େବତାର  ମାżମ , ଚତ ୁ ŵǃଗେର / 
ଚାରିଆେଡ଼  Ȅଚାର  
in the alternative  : ବିକƝେର  
in the background  : ପୃƪଭ ୂ ମିେର  
in the discharge  of : ନିବƽାହେର  
in the estimation  of : ମୂଲȻାŋନେର , ଆକଳନେର  
in the event  of : ଘଟଣା  ǰେମ 
in the execution  of : ନିƬାଦନେର , ପାଳନେର , 
ସଂପାଦନେର  
in the exercise  of : Ȅେୟାଗǰେମ  
in the first instance  : Ȅଥମତଃ , Ȅଥମେର  
in the form  of : ର ୂ ପେର  
in the interest  of : ହିତ ଦୃƨିର ୁ  in the least :  େଲଶ ମାǿାେର , ଅତି କମେର  
in the long run : ପରିେଶଷେର , ବହୁ ଦିନଧରି  ଚଳିବା  
ବା ଚେଳଇବା  
in the manner  provided  : ବȻବƳିତ  ରୀତିେର   
in the matter  of : ବିଷୟେର  
in the mean  time : ଇତȻବସରେର , ଏ ମżେର  
in the nick of time : ଠିକଣା  େବଳେର , େଶଷ 
ସମୟେର  
in the ordinary  course  of : ସାଧାରଣ  ǰମେର  
in the performance  of duties  : କŧƽବȻ  
ସƓାଦନେର  
in the prescribed  maner  : ବିହିତ/ନିŵǃƨ  ରୀତିେର  
in the presence  of : ଉପƳିତିେର  
in the scale  of : ହାରେର , ମାପେର , ମାପକ  ଅନୁସାେର  
in the teeth  of opposition  : ବିେରାଧ  ସେŨ 
in this behalf  : ଏତଦୁପଲେŁ , ଏହି ତରଫର ୁ  
in this state of affairs  : ଏହି ପରିƳିତିେର  
in time : ଠିǉ ସମୟେର  
in token  of : ନିଦଶƽନ  Ƹର ୂ ପ  
in transit  : 1.ଗƱ କାଳ ମżେର , 2. ଘଟିବା  ମଝିେର , 
େହବା  ମଝିେର  
in view of  : ଦୃେƨ, ଦୃƨିେର , ମତେର  
inability  (n) : ଅସାମଥƽȻ , ଅŁମତା  
in-absentia  (adv)  : ଅନୁପƳିତିେର  
inaccessible  (a) : 1. ଅପହř , ଅଗମȻ , 2. ଦୁଗƽମ , 
ସହଜେର  ବା ନିକଟେର  ଅȄାପȻ  
in-accordance -with : ଅନୁଯାୟୀ , ଅନୁସାେର  
inaccuracy  (n) : 1. ȇମ, 2. ତƿଟି 
inaccurate  (a) : 1. ଭ ୁ Ǥ, 2. ତƿଟିପୂťƽ , 3. ଯାହା ଠିǉ 
ନୁେହଁ 
inaction  (n) : 1. ନିƧିୟତା , 2. ଆଳସȻ  
inactive  (a) : ନିƦମƽା , ନିƧିୟ  
in addition  to : 1. ଆହୁରି  ମż, ଅǇକŽ ୁ , 2. େସǆ 
ସହିତ, ତା’ସହିତ 